0 0 0 0 0 0 0 0 0 0 0 0 0 0 0 0
0 0 0 0 0 0 0 0 0 0 0 0 0 0 0 0
0 0 0 0 0 0 0 0 0 0 0 0 0 0 0 0
0 0 0 0 3 3 3 3 3 3 3 3 0 0 0 0
0 0 0 0 3 1 1 3 1 1 1 3 0 0 0 0
0 0 0 0 3 1 4 2 2 4 1 3 0 0 0 0
0 0 0 0 3 5 4 2 6 1 3 3 0 0 0 0
0 0 0 0 3 1 4 2 2 4 1 3 0 0 0 0
0 0 0 0 3 1 1 3 1 1 1 3 0 0 0 0
0 0 0 0 3 3 3 3 3 3 3 3 0 0 0 0
0 0 0 0 0 0 0 0 0 0 0 0 0 0 0 0
0 0 0 0 0 0 0 0 0 0 0 0 0 0 0 0
0 0 0 0 0 0 0 0 0 0 0 0 0 0 0 0
0 0 0 0 0 0 0 0 0 0 0 0 0 0 0 0
0 0 0 0 0 0 0 0 0 0 0 0 0 0 0 0
0 0 0 0 0 0 0 0 0 0 0 0 0 0 0 0