0 0 0 0 0 0 0 0 0 0 0 0 0 0 0 0
0 0 0 0 0 0 0 0 0 0 0 0 0 0 0 0
0 0 0 0 0 3 3 3 3 3 3 3 3 0 0 0
0 0 0 0 0 3 1 1 1 1 3 3 3 0 0 0
0 0 0 0 0 3 1 4 1 1 1 1 3 0 0 0
0 0 0 3 3 3 1 4 1 3 3 1 3 0 0 0
0 0 0 3 2 2 2 1 4 1 1 1 3 0 0 0
0 0 0 3 2 2 2 4 3 4 1 3 3 0 0 0
0 0 0 3 3 3 3 1 3 1 4 1 3 0 0 0
0 0 0 0 0 0 3 1 1 1 5 1 3 0 0 0
0 0 0 0 0 0 3 3 3 3 3 3 3 0 0 0
0 0 0 0 0 0 0 0 0 0 0 0 0 0 0 0
0 0 0 0 0 0 0 0 0 0 0 0 0 0 0 0
0 0 0 0 0 0 0 0 0 0 0 0 0 0 0 0
0 0 0 0 0 0 0 0 0 0 0 0 0 0 0 0
0 0 0 0 0 0 0 0 0 0 0 0 0 0 0 0