0 0 0 0 3 3 3 3 0 0 0 0 0 0 0 0 
3 3 3 3 3 1 1 3 0 0 0 0 0 0 0 0
3 1 1 4 1 4 1 3 0 3 3 3 3 3 3 3
3 1 1 1 4 1 1 3 0 3 6 2 6 2 6 3 
3 3 1 4 1 4 1 3 3 3 2 6 2 6 2 3 
0 3 4 1 4 1 1 3 1 1 6 2 6 2 6 3 
0 3 5 4 1 4 1 1 1 1 2 6 2 6 3 3 
0 3 4 1 4 1 1 3 1 1 6 2 6 2 6 3 
3 3 1 4 1 4 1 3 3 3 2 6 2 6 2 3 
3 1 1 1 4 1 1 3 0 3 6 2 6 2 6 3 
3 1 1 4 1 4 1 3 0 3 3 3 3 3 3 3 
3 3 3 3 3 1 1 3 0 0 0 0 0 0 0 0 
0 0 0 0 3 3 3 3 0 0 0 0 0 0 0 0 
0 0 0 0 0 0 0 0 0 0 0 0 0 0 0 0 
0 0 0 0 0 0 0 0 0 0 0 0 0 0 0 0 
0 0 0 0 0 0 0 0 0 0 0 0 0 0 0 0  