0 0 0 0 0 0 0 0 0 0 0 0 0 0 0 0
0 0 0 0 0 0 0 0 0 0 0 0 0 0 0 0
0 0 0 0 0 3 3 3 3 3 0 0 0 0 0 0
0 0 0 0 0 3 1 5 1 3 0 0 0 0 0 0
0 0 0 0 0 3 4 4 4 3 0 0 0 0 0 0
0 0 0 3 3 3 3 1 1 1 3 0 0 0 0 0 
0 0 0 3 1 1 1 2 1 4 3 3 3 0 0 0  
0 0 0 3 1 4 2 4 2 1 2 3 3 0 0 0 
0 0 0 3 1 1 3 2 3 2 3 3 0 0 0 0 
0 0 0 3 3 3 3 3 3 3 3 0 0 0 0 0
0 0 0 0 0 0 0 0 0 0 0 0 0 0 0 0
0 0 0 0 0 0 0 0 0 0 0 0 0 0 0 0
0 0 0 0 0 0 0 0 0 0 0 0 0 0 0 0
0 0 0 0 0 0 0 0 0 0 0 0 0 0 0 0
0 0 0 0 0 0 0 0 0 0 0 0 0 0 0 0
0 0 0 0 0 0 0 0 0 0 0 0 0 0 0 0
0 0 0 0 0 0 0 0 0 0 0 0 0 0 0 0