0 0 0 0 0 0 0 0 0 0 0 0 0 0 0 0
0 0 0 0 0 0 0 0 0 0 0 0 0 0 0 0
0 0 0 0 0 0 0 0 0 0 0 0 0 0 0 0
0 0 0 0 0 0 3 3 3 3 0 0 0 0 0 0
0 0 0 0 0 3 3 1 1 3 0 0 0 0 0 0
0 0 0 0 0 3 5 4 1 3 0 0 0 0 0 0
0 0 0 0 0 3 3 4 1 3 3 0 0 0 0 0
0 0 0 0 0 3 3 1 4 1 3 0 0 0 0 0
0 0 0 0 0 3 2 4 1 1 3 0 0 0 0 0
0 0 0 0 0 3 2 2 6 2 3 0 0 0 0 0
0 0 0 0 0 3 3 3 3 3 3 0 0 0 0 0
0 0 0 0 0 0 0 0 0 0 0 0 0 0 0 0
0 0 0 0 0 0 0 0 0 0 0 0 0 0 0 0
0 0 0 0 0 0 0 0 0 0 0 0 0 0 0 0
0 0 0 0 0 0 0 0 0 0 0 0 0 0 0 0
0 0 0 0 0 0 0 0 0 0 0 0 0 0 0 0