0 0 0 0 0 0 0 0 0 0 0 0 0 0 0 0 
0 0 0 0 0 3 3 3 3 3 0 0 0 0 0 0 
0 0 0 3 3 3 1 1 1 3 3 3 0 0 0 0 
0 0 3 3 1 1 5 4 1 4 1 3 0 0 0 0 
0 0 3 1 1 3 3 1 3 3 1 3 3 0 0 0 
0 0 3 1 4 2 3 2 4 1 1 1 3 0 0 0 
0 0 3 1 3 2 3 6 3 1 1 1 3 0 0 0 
0 0 3 1 4 2 2 2 1 1 3 3 3 0 0 0 
0 0 3 3 3 4 3 1 3 3 3 0 0 0 0 0 
0 0 0 0 3 1 1 1 3 0 0 0 0 0 0 0 
0 0 0 0 3 3 3 3 3 0 0 0 0 0 0 0 
0 0 0 0 0 0 0 0 0 0 0 0 0 0 0 0 
0 0 0 0 0 0 0 0 0 0 0 0 0 0 0 0 
0 0 0 0 0 0 0 0 0 0 0 0 0 0 0 0 
0 0 0 0 0 0 0 0 0 0 0 0 0 0 0 0 
0 0 0 0 0 0 0 0 0 0 0 0 0 0 0 0