0 0 0 0 0 0 0 0 0 0 0 0 0 0 0 0 
0 0 3 3 3 3 3 3 3 3 3 3 3 3 3 0 
0 0 3 1 1 4 1 4 1 4 2 6 2 2 3 0 
0 0 3 1 4 1 4 1 4 1 6 2 2 2 3 0 
0 0 3 1 1 4 1 4 1 4 2 6 2 2 3 0 
0 0 3 1 4 1 4 1 4 1 6 2 2 2 3 0 
0 0 3 1 1 4 1 4 1 4 2 6 2 2 3 0 
0 0 3 1 4 1 4 1 4 1 6 2 2 2 3 0 
0 0 3 1 1 4 1 4 1 4 2 6 2 2 3 0 
0 0 3 1 4 1 4 1 4 1 6 2 2 2 3 0
0 0 3 1 1 4 1 4 1 4 2 6 2 2 3 0 
0 0 3 5 4 1 4 1 4 1 6 2 2 2 3 0
0 0 3 3 3 3 3 3 3 3 3 3 3 3 3 0  
0 0 0 0 0 0 0 0 0 0 0 0 0 0 0 0 
0 0 0 0 0 0 0 0 0 0 0 0 0 0 0 0 
0 0 0 0 0 0 0 0 0 0 0 0 0 0 0 0 
