0 0 0 0 0 0 0 0 0 0 0 0 0 0 0 0
0 0 0 0 0 0 0 0 0 0 0 0 0 0 0 0
0 0 0 0 0 0 0 0 0 0 0 0 0 0 0 0
0 0 0 3 3 3 3 3 3 3 0 0 0 0 0 0
0 0 0 3 1 1 2 4 1 3 3 3 0 0 0 0
0 0 0 3 1 2 4 2 4 1 1 3 0 0 0 0
0 0 0 3 6 4 2 4 2 5 1 3 0 0 0 0
0 0 0 3 1 2 4 2 4 1 3 3 0 0 0 0
0 0 0 3 1 1 2 4 1 1 3 0 0 0 0 0
0 0 0 3 3 3 3 3 3 3 3 0 0 0 0 0
0 0 0 0 0 0 0 0 0 0 0 0 0 0 0 0
0 0 0 0 0 0 0 0 0 0 0 0 0 0 0 0
0 0 0 0 0 0 0 0 0 0 0 0 0 0 0 0
0 0 0 0 0 0 0 0 0 0 0 0 0 0 0 0
0 0 0 0 0 0 0 0 0 0 0 0 0 0 0 0
0 0 0 0 0 0 0 0 0 0 0 0 0 0 0 0