0 0 0 0 0 0 0 0 0 0 0 0 0 0 0 0
0 0 0 0 0 0 0 0 0 0 0 0 0 0 0 0
0 0 0 0 0 0 0 0 0 3 3 3 3 3 0 0
0 0 0 0 0 0 0 0 0 3 1 1 1 3 0 0
3 3 3 3 3 3 3 3 3 3 1 6 1 3 3 3
3 1 1 1 1 1 1 1 1 1 1 2 1 1 1 3
3 1 4 4 4 4 6 6 6 6 4 2 2 2 5 3
3 1 1 1 1 1 1 1 1 1 1 2 1 1 1 3
3 3 3 3 3 3 3 3 3 3 1 6 1 3 3 3
0 0 0 0 0 0 0 0 0 3 1 1 1 3 0 0
0 0 0 0 0 0 0 0 0 3 3 3 3 3 0 0
0 0 0 0 0 0 0 0 0 0 0 0 0 0 0 0
0 0 0 0 0 0 0 0 0 0 0 0 0 0 0 0
0 0 0 0 0 0 0 0 0 0 0 0 0 0 0 0
0 0 0 0 0 0 0 0 0 0 0 0 0 0 0 0
0 0 0 0 0 0 0 0 0 0 0 0 0 0 0 0