0 0 0 0 0 0 0 0 0 0 0 0 0 0 0 0
0 3 3 3 3 3 3 3 3 3 3 3 3 3 3 0
0 3 2 1 1 1 1 1 1 1 1 1 1 1 3 0
0 3 2 4 1 4 1 4 1 4 1 4 1 1 3 0
0 3 2 3 3 3 3 3 3 3 3 3 1 1 3 0
0 3 2 3 2 6 1 4 1 2 2 4 6 3 3 0
0 3 2 3 1 4 1 4 1 6 2 4 5 3 0 0
0 3 2 3 2 1 1 4 1 2 2 4 4 3 0 0
0 3 2 3 3 3 3 3 3 3 3 3 2 3 0 0
0 3 2 1 1 1 1 1 1 1 1 1 1 3 0 0
0 3 2 3 4 3 4 3 4 3 4 3 4 3 0 0
0 3 2 1 1 1 1 1 1 1 1 1 1 3 0 0
0 3 3 3 3 3 3 3 3 3 3 3 3 3 0 0
0 0 0 0 0 0 0 0 0 0 0 0 0 0 0 0
0 0 0 0 0 0 0 0 0 0 0 0 0 0 0 0
0 0 0 0 0 0 0 0 0 0 0 0 0 0 0 0