0 0 0 0 0 0 0 0 0 0 0 0 0 0 0 0
0 0 0 0 0 0 0 0 0 0 0 0 0 0 0 0
0 3 3 3 3 0 0 0 0 0 0 3 3 3 3 0
0 3 2 2 3 3 3 3 3 3 3 3 2 2 3 0
0 3 6 2 6 2 2 2 2 2 6 2 6 2 3 0
0 3 1 4 1 4 1 4 1 4 1 4 1 4 3 0
0 3 4 1 4 1 4 5 4 1 4 1 4 1 3 0
0 3 1 4 1 4 1 4 1 4 1 4 1 4 3 0
0 3 4 1 4 1 4 1 4 1 4 1 4 1 3 0
0 3 2 6 2 6 2 2 2 2 2 6 2 6 3 0
0 3 2 2 3 3 3 3 3 3 3 3 2 2 3 0
0 3 3 3 3 0 0 0 0 0 0 3 3 3 3 0
0 0 0 0 0 0 0 0 0 0 0 0 0 0 0 0
0 0 0 0 0 0 0 0 0 0 0 0 0 0 0 0
0 0 0 0 0 0 0 0 0 0 0 0 0 0 0 0
0 0 0 0 0 0 0 0 0 0 0 0 0 0 0 0