0 0 0 0 0 0 0 0 0 0 0 0 0 0 0 0 
0 0 0 0 0 0 0 0 0 0 0 0 0 0 0 0
0 0 0 0 0 0 0 0 0 0 0 0 0 0 0 0
0 0 0 0 0 0 0 0 0 0 0 0 0 0 0 0
0 0 0 0 0 3 3 3 3 3 0 0 0 0 0 0 
0 0 3 3 3 3 2 1 1 3 3 0 0 0 0 0
0 0 3 1 4 2 4 2 1 1 3 0 0 0 0 0
0 0 3 5 4 3 1 3 4 1 3 0 0 0 0 0
0 0 3 1 4 2 1 2 1 1 3 0 0 0 0 0 
0 0 3 3 3 3 4 3 4 1 3 0 0 0 0 0
0 0 0 0 3 2 1 2 1 1 3 0 0 0 0 0
0 0 0 0 3 3 3 3 3 3 3 0 0 0 0 0
0 0 0 0 0 0 0 0 0 0 0 0 0 0 0 0 
0 0 0 0 0 0 0 0 0 0 0 0 0 0 0 0
0 0 0 0 0 0 0 0 0 0 0 0 0 0 0 0
0 0 0 0 0 0 0 0 0 0 0 0 0 0 0 0