0 0 0 0 0 0 0 0 0 0 0 0 0 0 0 0 
0 0 0 0 0 0 0 0 0 0 0 0 0 0 0 0
0 0 0 0 0 0 0 3 3 3 3 3 3 3 3 0
0 0 0 0 0 0 0 3 1 1 3 1 1 1 3 0
0 3 3 3 3 3 3 3 1 4 4 2 2 2 3 0
0 3 1 1 1 1 1 1 1 1 3 2 2 2 3 0
0 3 1 3 3 3 3 3 3 4 3 2 2 2 3 0
3 3 1 3 1 1 1 1 1 1 3 2 2 2 3 0
3 1 1 3 1 3 4 1 4 1 3 3 3 3 3 0
3 1 3 1 4 1 4 1 4 1 3 0 0 0 0 0
3 1 5 1 1 4 1 3 1 1 3 0 0 0 0 0
3 3 3 3 3 4 1 4 4 1 3 0 0 0 0 0
0 0 0 0 3 1 1 1 1 1 3 0 0 0 0 0
0 0 0 0 3 3 3 3 3 3 3 0 0 0 0 0
0 0 0 0 0 0 0 0 0 0 0 0 0 0 0 0 
0 0 0 0 0 0 0 0 0 0 0 0 0 0 0 0