0 0 0 0 0 0 0 0 0 0 0 0 0 0 0 0 
0 0 0 0 0 0 0 0 0 0 0 0 0 0 0 0
0 0 0 0 0 0 0 0 0 0 0 0 0 0 0 0 
0 0 0 0 0 0 3 3 3 3 3 3 3 3 0 0 
0 0 0 3 3 3 3 1 1 1 1 2 1 3 0 0
0 0 0 3 1 1 4 1 4 1 4 2 5 3 0 0
0 0 0 3 1 1 2 3 3 3 3 2 3 3 0 0
0 0 0 3 1 4 2 4 1 4 1 1 3 0 0 0
0 0 0 3 1 1 2 1 1 3 3 3 3 0 0 0
0 0 0 3 3 3 3 3 3 3 0 0 0 0 0 0
0 0 0 0 0 0 0 0 0 0 0 0 0 0 0 0 
0 0 0 0 0 0 0 0 0 0 0 0 0 0 0 0
0 0 0 0 0 0 0 0 0 0 0 0 0 0 0 0 
0 0 0 0 0 0 0 0 0 0 0 0 0 0 0 0
0 0 0 0 0 0 0 0 0 0 0 0 0 0 0 0
0 0 0 0 0 0 0 0 0 0 0 0 0 0 0 0