0 0 0 0 0 0 0 0 0 0 0 0 0 0 0 0
0 0 0 0 0 0 0 0 0 0 0 0 0 0 0 0
0 0 0 0 0 0 0 0 0 0 0 0 0 0 0 0
0 0 0 0 0 3 3 3 3 3 0 0 0 0 0 0
0 0 0 3 3 3 1 5 1 3 3 3 0 0 0 0
0 0 0 3 1 1 4 1 4 1 1 3 0 0 0 0
0 0 0 3 1 6 2 6 2 6 1 3 0 0 0 0
0 0 0 3 1 2 4 1 4 2 1 3 0 0 0 0
0 0 0 3 1 6 2 6 2 6 1 3 0 0 0 0
0 0 0 3 1 1 4 1 4 1 1 3 0 0 0 0
0 0 0 3 3 3 3 3 3 1 1 3 0 0 0 0
0 0 0 0 0 0 0 0 3 3 3 3 0 0 0 0
0 0 0 0 0 0 0 0 0 0 0 0 0 0 0 0
0 0 0 0 0 0 0 0 0 0 0 0 0 0 0 0
0 0 0 0 0 0 0 0 0 0 0 0 0 0 0 0
0 0 0 0 0 0 0 0 0 0 0 0 0 0 0 0