0 0 0 0 0 0 0 0 0 0 0 0 0 0 0 0
0 3 3 3 3 3 3 3 3 3 3 3 3 3 3 0
0 3 1 5 1 6 1 6 1 6 1 3 1 1 3 3
0 3 4 3 1 1 6 1 6 1 1 3 1 1 1 3
0 3 1 3 1 6 1 6 1 6 1 1 1 1 1 3
0 3 1 3 1 1 6 1 6 1 1 3 3 1 3 3
0 3 1 3 1 6 1 6 1 6 1 3 3 1 3 0
0 3 1 3 1 1 6 1 6 1 1 3 3 1 3 0
0 3 1 3 1 6 1 6 1 6 1 3 3 1 3 0
0 3 1 3 1 1 6 1 6 1 1 3 3 1 3 0
0 3 1 3 1 6 1 2 1 6 1 3 3 1 3 3
3 3 1 3 3 3 3 3 3 3 3 3 3 1 1 3
3 1 1 1 1 1 1 1 1 1 1 1 1 1 1 3
3 1 1 1 3 3 3 3 3 3 3 3 3 1 1 3
3 3 3 3 3 0 0 0 0 0 0 0 3 3 3 3
0 0 0 0 0 0 0 0 0 0 0 0 0 0 0 0