0 0 0 0 0 0 0 0 0 0 0 0 0 0 0 0
0 0 0 3 3 3 3 0 0 3 3 3 3 3 3 0
0 0 0 3 1 1 3 3 3 3 1 1 1 1 3 0
0 0 3 3 6 1 1 1 6 1 6 6 1 1 3 0
0 0 3 1 4 1 6 1 1 1 1 6 3 1 3 0
0 0 3 1 2 1 1 1 3 3 3 1 1 1 3 0
0 0 3 3 3 3 3 3 1 1 1 3 5 3 3 0
0 0 3 1 6 1 2 1 6 1 1 6 6 1 3 0
0 0 3 1 1 1 3 1 1 1 3 1 1 1 3 0
0 0 3 3 6 1 1 1 6 1 3 4 3 1 3 0
0 0 0 3 1 1 3 3 3 3 3 1 1 1 3 0
0 0 0 3 3 3 3 0 0 0 3 3 3 3 3 0
0 0 0 0 0 0 0 0 0 0 0 0 0 0 0 0
0 0 0 0 0 0 0 0 0 0 0 0 0 0 0 0
0 0 0 0 0 0 0 0 0 0 0 0 0 0 0 0
0 0 0 0 0 0 0 0 0 0 0 0 0 0 0 0
0 0 0 0 0 0 0 0 0 0 0 0 0 0 0 0




