0 0 0 0 0 0 0 0 0 0 0 0 0 0 0 0
0 0 0 0 0 0 0 0 0 0 0 0 0 0 0 0
0 0 0 0 0 0 0 0 0 0 0 0 0 0 0 0
0 0 0 3 3 3 3 3 3 3 0 0 0 0 0 0
0 0 0 3 1 1 6 1 1 3 0 0 0 0 0 0
0 0 0 3 1 5 2 4 1 3 0 0 0 0 0 0
0 0 0 3 1 4 2 1 1 3 0 0 0 0 0 0
0 0 0 3 6 2 6 6 6 3 0 0 0 0 0 0
0 0 0 3 1 1 6 1 1 3 0 0 0 0 0 0
0 0 0 3 1 4 6 4 1 3 0 0 0 0 0 0
0 0 0 3 1 1 2 1 1 3 0 0 0 0 0 0
0 0 0 3 3 3 3 3 3 3 0 0 0 0 0 0
0 0 0 0 0 0 0 0 0 0 0 0 0 0 0 0
0 0 0 0 0 0 0 0 0 0 0 0 0 0 0 0
0 0 0 0 0 0 0 0 0 0 0 0 0 0 0 0
0 0 0 0 0 0 0 0 0 0 0 0 0 0 0 0